#E#############
#c#ccccccccccc#
#ccc#####c#####
#c#c###ccc#c###
#####c###ccc#c#
#cc#cccccc#ccc#
##c########c#c#
#ccccccccccc#c#
##c##c#c#c###c#
#ccc###c####cc#
######cc#cccc##
#cccccc###c#cc#
######c#ccc#c##
#cccccc##c##cc#
#############S#
###############